001101100100001
000000000001000
000101000000000
100001101001000
001000101100000
000000001000100
000001000011000
100010000110010
000010000000001
100000010110100
000000000001000
000010000000000
000100001001110
010001000010000
110001110000000
001000001101000
