01100000000000
00100001000000
10000000000000
00000000000000
10000010010000
00000001000001
00000110000010
01001000100000
10000100010010
00000000000000
00010000010000
01000001011000
00110110000000
