00000100000
11010110100
00001000001
00101100000
00011110100
00100101000
01101110110
00100110001
11000000010
10000100000
11001010010
10101000001
00001101010
