10000000010100
00000001001000
00000100000010
00000000001000
00100101101000
10001000010000
00100000010010
00001000000100
01010000000000
00000101000011
00100000101001
01000010000000
10000000000000
