000101110000100101
000101000001110001
101001010010010000
101000000100100010
000100101110000000
000000110000101010
010000010001000010
000011000100000000
100000000000000111
100000000010100000
000001010001000000
000010000001000110
110001010000010010
101000100000010000
000000000000100000
100010000100010000
000000101100000000
010000000000010010
