01010001001111011010
01000100000101000100
10001000000010000000
10001100000011010100
11110011001110001101
00101100111000101110
10100101101000001100
10000111101001000011
01011001000000010101
00110010000111000010
11110000000001110000
00000010000000100010
10111000101110010101
00101100100100100000
11000000110010100011
10010010001110000001
00101101001101110101
