0011000010000100001
0000100100010010000
0110001100101000001
0000100110000000001
0101000000100011000
1001100000011010000
0001000100010000010
0000100110101000000
0000000011010000001
0100010001010000010
1000000010100000010
