0000001000100
0000000000000
0000000100000
1000000000000
0000011000001
0000000000001
0001000000000
0010001000001
1000001010000
0100000001001
0100000000100
0001101001010
0111000011000
0000111100010
1010100001001
0100001000010
