01001000000000000
00110000010110010
10000000100000100
00000000011000000
00001000000000000
01100000000000010
00110000000000000
00100100010010000
00100000000000000
00000011000000010
00000000000100001
00010000000001000
01010000000000000
10100110000000000
00000000101000000
00000100000000000
00001000110000101
00000000000000000
00001000000010000
00110110110000010
