01000100
01110010
00011000
00000100
00010000
00000110
00011001
