00101100101
01001010000
10101000010
01000001011
00000111001
00001001100
01110100000
10000001100
10010101001
01011100000
01100000110
00010000000
00000101000
00010000001
