1000000001
1011010100
0000101000
0100101010
0001101010
0101000000
0111001010
0000010000
0000010000
0000011000
