01111000110000
11011001011000
01000000000000
11001000000000
00001010100000
00001101111011
11000001111010
10010000000100
10000101101001
01110001010000
01100001000101
00000100100111
11001000000100
10010000000001
00000001010001
00001100010100
00011101010011
00001111011100
01000000011001
00010000001001
